1111111111111111111111111
1E000000000000000C00000C1
1010010100100000101001001
1010010010101010001001001
1P0000000C00C000000000001
1111111111111111111111111