1111111111111111111111111
10000000000000000C00001C1
1010010100100000101000001
10100100101010100010011E1
1P0000000C00C0000000001C1
1111111111111111111111111