1111111111111111111111111
1000000000E000000C00001C1
1010010100100000101001001
1010010010101010001001111
1P0000000C00C000000000001
1111111111111111111111111