1111111111111111111111111
10000000000000000C00001C1
1010010100100000101001001
10100100101010100E1001101
1P0000000C00C000000000001
1111111111111111111111111