1111111111111111111111111
10000000000000000C0000101
10100101001000001010011C1
1010010010101010001001011
1P0000000C00C0000000000E1
1111111111111111111111111